..........
.        .
.......  .
.  .     .
.  .  ....
. X      .
..........