   ........................................................................................
      .     .  .  .        .     .        .     .     .  .     .        .     .           .
.  .......  .  .  ....  ....  .  .  ....  ....  ....  .  .  ....  ..........  .  .......  .
.        .     .           .  .        .        .     .        .  .        .  .  .  .     .
....  .  .  .  ....  ...................  ....  .  ..........  .  ....  ....  ....  ....  .
.  .  .     .        .           .  .  .  .     .  .  .  .                       .        .
.  .  ....  ..........  .  .  .  .  .  ....  ....  .  .  ....  .  ....  .  ....  ....  ....
.  .  .  .  .     .  .  .  .  .              .           .  .  .  .     .     .  .  .     .
.  ....  .  .  ....  .  .  .  .  ..........  ....  .......  ....  ....  ....  ....  .  ....
.     .           .  .  .  .  .  .     .  .     .           .  .  .        .        .  .  .
.  .  ....  .......  .  .......  .  ....  .  .  ....  .......  .......  .  ....  .  .  .  .
.  .     .     .        .        .     .     .              .     .     .  .     .  .  .  .
.  ....  ....  .  .  .......  ....  .  .  ................  ....  .  .  .  ....  .  .  .  .
.  .        .     .        .        .  .        .        .           .  .  .  .  .        .
..........  ....  ......................  .......  ....  .......  .  .  ....  .......  .  .
.     .        .  .     .           .           .     .     .     .  .  .           .  .  .
....  .......  ....  .............  ....  ..........  .......  .......  .  .  .  ....  ....
.           .     .  .           .     .     .        .  .  .  .        .  .  .           .
....  ....  .  ....  .  .  ....  .  ....  .  ....  .  .  .  .  .......  ....  .  ..........
.  .     .        .     .  .  .  .        .  .  .  .     .  .  .     .  .  .  .  .     .  .
.  .  .......  .............  .  ....  ....  .  .......  .  .  .  .......  ..........  .  .
.  .     .  .     .                    .     .     .  .     .  .     .     .     .        .
.  .  .  .  .......  .  .......  .  .  .......  .  .  .  ....  ....  .  .......  .  ....  .
.  .  .        .  .  .     .     .  .        .  .                    .     .  .  .     .  .
.  .......  .  .  .  .  ....  .  ....  .  .......  .......  .  ....  ....  .  .  .......  .
.  .     .  .  .     .  .  .  .  .  .  .  .     .  .  .  .  .  .  .  .     .        .     .
.  ....  .  .  .  .  ....  ....  .  ....  .  ....  .  .  .  .  .  ....  .  ....  .......  .
.           .  .  .  .     .        .  .  .  .  .  .        .     .     .  .     .        .
..........  .  ....  .  ....  ....  .  .  .  .  ....  .......  ....  .  ....  .  ....  ....
.     .  .  .     .  .        .        .  .        .  .  .  .  .     .  .     .           .
....  .  .  .  .  .  .  ....  ....  ....  .  .......  .  .  ..........  ....  ..........  .
.  .  .  .  .  .     .  .     .     .  .     .     .  .  .        .        .        .  .  .
.  .  .  ....  ....  .......  .......  .  .......  .  .  ....  .  ....  .  .  .......  .  .
.                 .  .        .  .     .        .              .  .  .  .  .  .           .
.  ....  ....  ....  .......  .  .  ....  .............  .  .......  .  .......  .  .......
.     .  .     .           .     .     .     .  .  .  .  .     .              .  .        .
.  .  ....  ....  .  .  ..........  ....  ....  .  .  .  .............  .  .  .  .......  .
.  .     .  .     .  .     .                    .  .     .  .           .  .     .        .
.  ....  ......................  .......  ....  .  .......  .......  .  ....  ....  ....  .
.  .     .     .                 .           .  .              .  .  .  .        .     .  .
.  .  ....  .......  ................  .  ................  ....  .  ..........  ....  ....
.  .  .     .     .        .  .     .  .  .        .                 .  .     .  .  .  .  .
....  ....  ....  ..........  .  ....  .......  .  ....  .............  .  .  ....  ....  .
.  .  .                 .        .  .  .     .  .  .     .           .     .        .     .
.  .  ....  ....  .......  ....  .  .......  ....  .  ....  .  .  ....  .  .  ....  .  ....
.     .        .           .  .  .        .                 .  .        .  .     .        .
....  .  .  ....  .  ....  .  .  .......  .  ....  ..........  .  .............  .  .  .  .
.  .  .  .  .     .     .  .           .     .     .     .     .     .           .  .  .  .
.  .  ..........  ................  ....  .............  .  .............  ..........  ....
.  .                 .           .           .  .  .           .        .  .           .  .
.  ..........  ....  .  ................  ....  .  .  .  .  .  .  ................  ....  .
.           .  .  .  .        .  .     .     .     .  .  .  .     .  .  .     .        .  .
..........  .  .  ....  .  ....  ....  .  .......  ................  .  ....  ....  ....  .
.  .  .  .  .     .     .     .     .     .           .  .  .  .           .        .     .
.  .  .  .  .  .  ....  .......  .  .  ....  .X ....  .  .  .  .......  .............  .  .
.              .        .  .     .  .        .     .           .  .        .        .  .  .
.  ..........  .  ....  .  ....  .............  ....  .......  .  .  ....  ....  .......  .
.           .  .     .        .        .  .  .  .     .              .  .  .     .  .     .
.  .  ..........  ....  .  ....  .......  .  .......  .  .......  ....  .  ....  .  ....  .
.  .        .  .  .  .  .        .  .  .  .  .     .  .     .  .  .  .                    .
.  ....  ....  .  .  ....  .  ....  .  .  .  .  ....  .  .  .  .  .  ..........  ..........
.     .  .  .     .        .        .  .           .  .  .     .  .           .  .     .  .
.  .  ....  .......  .  .  ....  ....  .  ....  .  ....  ....  .  .  ..........  ....  .  .
.  .  .        .     .  .  .  .     .        .  .     .  .  .  .  .  .     .  .     .  .  .
.  .  .  .  ..........  .  .  ..........  ................  .......  .  ....  .  .  .  .  .
.  .  .  .  .  .     .  .           .     .                 .  .  .  .           .     .  .
....  .  ....  .  .  ....  ..........  ....  .  .  ..........  .  .  .............  .  .  .
.  .  .  .  .     .     .           .        .  .  .        .           .  .        .     .
.  ....  .  .  ....  ......................  ....  .  .  ....  .  .  ....  .......  .  ....
.        .  .  .                 .  .     .     .     .     .  .  .  .     .  .     .     .
.......  .  .  ....  .  .  .......  .  .  .............  .......  .......  .  ..........  .
.        .        .  .  .        .  .  .     .  .     .  .  .     .  .  .  .  .           .
.......  .  ..........  .  .......  .  .......  .  ....  .  ....  .  .  .  .  ....  .  ....
.           .  .        .  .  .  .        .  .        .  .     .                 .  .  .  .
.  ....  ....  ..........  .  .  .  .  .  .  .......  .  ....  .  .............  .  ....  .
.  .  .  .  .  .        .           .  .  .  .              .  .        .  .  .     .  .  .
....  ....  .  ....  .......  .............  ....  .  ....  .  ....  ....  .  .  ....  .  .
.     .        .              .  .                 .     .     .     .        .           .
....  .  .  .............  .  .  ....  .......  ....  ....  .  ..........  .  .  .......  .
.  .     .           .     .     .     .  .     .  .  .  .  .     .  .     .     .        .
.  .............  ....  .  .............  .......  .  .  .  .  .  .  ..........  ..........
.                    .  .     .  .  .     .     .     .     .  .        .  .  .           .
....  .  ....  ..........  .  .  .  .  .  .  ....  .......  ....  ....  .  .  .  ..........
.  .  .     .     .  .     .  .     .  .              .        .  .           .  .        .
.  .  ....  .  ....  ....  ....  .  ....  ....  ....  ....  .............  ....  .......  .
.     .     .                 .  .  .     .     .     .           .                    .  .
.......  .  .  .......  .  ....  .......  ..........  .......  ................  .  .  .  .
.        .  .        .  .  .        .           .  .        .  .  .  .  .        .  .     .
....  ....  .......  .......  .............  .  .  ....  .  ....  .  .  ....  .  .  ....  .
.  .  .  .  .     .        .                 .  .        .  .  .        .  .  .  .  .     .
.  ....  .......  .  .  .......  .  .  .......  .............  .  .  ....  ....  ....  ....
.        .           .        .  .  .  .     .  .     .           .  .  .        .        .
.  ..........  .  .  .......  .  .  .......  .  .  .  .  .  .......  .  .  .  .  ....  ....
.        .  .  .  .        .     .        .     .  .  .  .  .              .  .     .     .
.  ....  .  .  .......  .......  .......  ..........  ....  ..........  ....  ....  .  .  .
.  .     .        .     .        .        .        .           .  .  .  .     .     .  .  .
.......  .  .............  ..........  .......  .  .  ..........  .  .  .............  ....
.           .     .        .     .  .        .  .        .  .     .              .  .     .
.  .............  ....  .  ....  .  .  ....  .......  ....  .  .  .  ....  .  ....  .  .  .
.     .                 .        .        .     .              .  .     .  .     .     .  
........................................................................................  