............................
.           .  .           .
.  .  ....  .  .  .......  .
.  .  .        .        .  .
.......  ....  ..........  .
.        .                 .
..........  .  .......  .  .
.     .     .  .     .  .  .
....  .  ....  .  .  .......
.     .     .     .  .  .  .
.  .  .......  ....  .  .  .
.  .        . X.           .
.  .......  ....  ....  ....
.  .     .  .     .  .  .  .
.  .  ....  .......  .  .  .
.  .           .  .  .  .  .
..........  ....  .  .  .  .
.                          .
............................