........................................
.     .     .     .  .  .  .        .  .
.  .......  .  ....  .  .  .  ....  .  .
.                 .        .     .  .  .
.  ....  .......  .  .  .  ....  .  .  .
.     .        .     .  .  .     .     .
.  ....  .............  ..........  ....
.     .     .        .           .     .
..........  .......  .  .......  .  .  .
.           .  .  .        .  .  .  .  .
.  .  .......  .  .......  .  .  .  .  .
.  .          .     .        .     .  .
....  .......  .  ....  ....  .  ....  .
.     .              .  .     .  .     .
..........  .  ....  .  .......  ....  .
.  .        . X.     .  .  .        .  .
.  .  .............  .  .  ....  ....  .
.           .  .        .  .        .  .
....  .......  ..........  .  ....  .  .
.     .     .     .     .        .  .  .
.  .  .  .......  ....  .............  .
.  .  .        .  .        .  .  .     .
.  ....  .......  ....  ....  .  ....  .
.        .     .  .  .  .  .  .        .
.  ..........  .  .  .  .  .  .  .  ....
.     .                          .     .
........................................
