..................................
.                                 .
.   . .   . .   . .   . .   . .   .
.   . .   . .   . .   . .   . .   .
.                                 .
.   . .   . .   . .   . .   . .   .
.   . .   . .   . .   . .   . .   .
.                                 .
.   . .   . .   . .   .  .   . .  .
.   . .   . .   . .   .  .   . . X.
.                                 .
...................................