....................................................................................................
.                                              ..                                                  .
.                                              ..                          ..                      .
.                                              ..                          ..                      .
.      ..............                          ..                  ...     ..                      .
.            .............                     ..                  ...     ..   ....................
.                                              ..                  ...     ..   ....................
.       ....  .   .  .  .....                                                   ...     ..         .
.       .  .  .. ..  .    .            ........                     .........   ...     ..         .
.       ....  . . .  .    .            ........                    .........    ...     ..         .
.       ..    .   .  .    .            ........                                 ...     ..         .
.       . .   .   .  .    .        .   ........                        ..                       ....
.       .  .  .   .  .    .        .   ........                        ..                       ....
.                                  .                                   ..  ..           .......    .
.    ..       ..    ..       ..    .        ..      ..    ...          ..  ..           .......    .
.    ....     ..    ....     ..    .        ..      ..    .....        ..  ..                      .
.    .. ..    ..    .. ..    ..        .    ..      ..    ..  ...  ..      ..                      .
.    ..  ..   ..    ..  ..   ..   .......   ..........    ..   ..  ..      ..                      .
.    ..   ..  ..    ..   ..  ..   .......   ..........    ..   ..  ..      ..                      .
.    ..    .. ..    ..    .. ..        .    ..      ..    ..  ...          ..                      .
.    ..     ....    ..     ....             ..      ..    .....            ..    ..........        .
.    ..       ..    ..       ..             ..      ..    ...              ..    ..........        .
.                                                                          ..                      .
.      .            .           .            .                             ..          X           .
.      .     .      .           .            .                             ..                      .
.      .     .      .                        .        .                    ..                      .
.      .     .      .                        .        .                    ..                      .
.      .     .      .           .            .        .                    ..                      .
.            .                  .                     .                    ..                      .
....................................................................................................