......................................................................
.               .     .     .           .  .  .                      .
.  ....  .  ....  ....  .  ....  ....  .  .  ....  .......  ....  ....
.  .  .  .     .     .  .  .  .     .  .  .     .  .     .     .     .
.  .  ....  .  ....  .  .  .  .  .  ....  ....  ....  .  .  ..........
.     .     .           .        .  .  .  .        .  .           .  .
..........  ....  ....  .......  ....  .  ....  .......  ..........  .
.           .  .  .     .           .           .  .  .              .
..........  .  ....  ....  .  ..........  .  .  .  .  .  .  ....  .  .
.           .     .  .  .  .              .  .  .  .     .     .  .  .
.............  ....  .  ................  .......  .  .  ..........  .
.     .           .        .        .                 .  .     .     .
....  ....  ..........  ....  ....  .  .......  ..........  .  ....  .
.                       .  .  .     .     .        .     .  .  .     .
.  .............  .......  .  ....  ....  .......  .  .  .  ....  ....
.        .           .  .        .     .  .  .  .  .  .  .  .     .  .
................  ....  ....  .......  ....  .  .......  .  .  ....  .
.              .  .           .     .  .           .  .        .     .
.  .  .  .............  ....  .  .  .......  .......  .  ....  .  ....
.  .  .     .        .     .  .  .  .     .     .        .           .
....  .  ....  .  .  .  ....  .  .......  ....  .  .............  ....
.  .  .        .  .        .              .  .        .        .     .
.  ....  ....  .......  .  .  .......  .  .  ....  ....  .......  .  .
.        .        .     .  .  .  .  .  .                       .  .  .
.  .  .  ....  ..........  .  .  .  .  .............  ..........  .  .
.  .  .  .  .        .  .  .        .  .  .           .  .        .  .
..........  ..........  .  .............  ....  ....  .  .............
.           .        .     .        .     .        .  .  .           .
.  .  .............  .  ....  .  .......  .  .  .  .  .  .  .......  .
.  .  .  .        .        .  .  .           .  .  .     .  .        .
....  .  .  .......  ....  .  ....  .  ....  .  .  ....  .......  ....
.        .     .     .  .  .     .  .     .  .  .     .  .  .     .  .
....  ....  .......  .  .......  ....  .......  .......  .  .  ....  .
.  .        .     .           .  .  .        .  .  .  .              .
.  .  ..........  .  .  ....  .  .  .  .  .......  .  ....  .  ....  .
.                    .     .     .  .  .  .  .  .        .  .  .     .
....  .  ................  .......  .......  .  .......  .  .......  .
.     .              .  .        .        .        .  .  .  .     .  .
....  ....  ....  .  .  .  ....  .......  ....  .  .  .  .......  .  .
.        .     .  .     .     .                 .     .  .  .        .
.  ....  ....  ......................  ..........  ....  .  .......  .
.     .     .  .              .     .  .  .              .  .  .  .  .
.  .......  .......  ..........  .  ....  ....  ....  ....  .  .  .  .
.  .     .     .     .     .  .  .           .     .           .  .  .
.  .  .......  .  .  .  .  .  ....  .............  .............  ....
.        .     .  .     .  .           .                 .     .  .  .
....  .......  ....  .  ....  .  ....  ..........  ....  .  ....  .  .
.           .     .  .  .  .  .     .  .     .     .           .     .
.  .  ....  ....  .  ....  .......  ....  .  .  ....  .............  .
.  .  .        .           .     .     .  .  .  .                    .
.......  .  .......  .......  ....  .  .  .  .  ....  .  .......  ....
.        .  .     .        .     .  .  .  .  .  .     .        .     .
.......  .  .  .  .  .......  ....  ....  .............  ..........  .
.     .  .  .  .  .                    .  .     .           .     .  .
.  .  ....  ....  .  ....  .  ....  ....  .  .......  .......  ....  .
.  .           .        .  .     .              .  .     .  .        .
....  ....  .  .  .  .......  ....  ....  ....  .  .  ....  ..........
.  .  .  .  .  .  .  .  .        .  .  .     .     .                 .
.  ....  .  ....  .  .  .......  ....  .  ..........  .  .  ....  ....
.        .  .     .  .              .     .           .  .  .        .
.  ....  .  .......  ....  .  .......  .  .......  ..........  ....  .
.     .           .  .  .  .        .  .  .     .     .  .  .  .     .
....  ..........  .  .  ....  .  .  .......  .  .  ....  .  .  .X ....
.        .        .        .  .  .        .  .              .  .     .
......................................................................