...............................
.               .             .
.  .  .  ....  .......  .......
.  .  .     .     .           .
....  .  ..........  .......  .
.     .        .  .        .  .
.  .......  ....  ....  .......
.     .  .              .     .
....  .  ....  .............  .
.  .  .  .           .  .     .
.  .  .  ..........  .  ....  .
.     .  .           .        .
.  ....  ....  ....  ....  .  .
.     .     .  .           .  .
....  .  .  ....  .............
.     .  .           .     .  .
.  ....  .......  ....  ....  .
.     .     .  .           .  .
.  ....  .  .  .  .  .  ....  .
.     .  .     .  .  .        .
.  ....  .  .  .  .......  .  .
.     .  .  .  .        .  .  .
.  .  .  ..........  ....  .  .
.  .           .  .     .  .  .
.  ....  .......  .  ..........
.  .              .  .  .  .  .
.......  ..........  .  .  .  .
.     .     .  .  .     .     .
....  .  ....  .  .  ....  .  .
.        .                 . X.
...............................