..........
.        .
........ .
.  .     .
.  .  ....
.       X.
..........