.........................
.           .     .     .
.  .  ....  ....  ....  .
.  .  .     .        .  .
....  .......  .  ....  .
.     .        .  .     .
.  ....  ..........  .  .
.        .  .        .  .
.  ....  .  ....  .  .  .
.  .     .        .  .  .
.  ....  .............  .
.  .                 .  .
.  ................  .  .
.        .  .  .  .  .  .
.......  .  .  .  .  .  .
.        .             X.
.........................