..........
         .
.......  .
.  .     .
.  .  ....
. X      .
..........