.........................................................................................................................
.        .     .        .        .           .  .           .        .  .  .        .           .     .                 .
.  .  .  .  ....  .......  .  .......  .......  .  ..........  .  .  .  .  ....  .......  .  .......  .............  ....
.  .  .           .  .     .     .     .     .              .  .  .  .                    .     .              .     .  .
.  .......  ....  .  ....  ....  .  ....  .  .......  .............  .  ....  .  ....  .......  .  ....  .......  ....  .
.  .           .     .     .           .  .  .  .        .        .        .  .  .     .              .        .        .
.  ....  ................  ..........  .  ....  .  .  .  .  .  ....  ...................  .......  .  .  .  .......  ....
.  .              .  .  .     .           .     .  .  .     .  .     .     .        .     .  .  .  .  .  .           .  .
....  .......  ....  .  .............  .  ....  .  ...................  .......  .  ....  .  .  ..........  .......  .  .
.     .     .  .     .     .        .  .  .     .           .        .           .     .  .        .  .  .        .  .  .
.  ....  ....  .  .  .  .......  ....  .  ....  .  .......  ....  ....  .  ....  .......  .  .  ....  .  .  .  .......  .
.        .  .  .  .     .  .  .     .  .     .     .           .  .     .     .  .  .  .  .  .           .  .           .
....  ....  .  ....  .  .  .  ....  .  .  .  .  .  ..........  .  .  .............  .  .  .  .......  ....  ....  .  ....
.     .  .           .                 .  .     .           .  .           .  .     .  .  .     .              .  .     .
....  .  .  .  .  .......  .......  .........................  .  .  .......  ....  .  ....  .........................  .
.     .     .  .  .        .     .  .  .              .     .  .  .     .     .        .              .        .        .
....  ................  ....  .  .  .  .......  ....  .  ....  .......  ....  .  ..........  .  .......  .  .  .  ....  .
.  .        .              .  .        .  .        .  .  .  .           .  .              .  .           .  .  .  .     .
.  .  .......  ..........  .......  ....  ....  ....  .  .  ..........  .  .......  ..........  ...................  ....
.  .  .        .     .     .     .           .     .     .     .                    .     .  .  .     .  .        .     .
.  .  ..........  ..........  .............  ..........  .  .  .  .  ....  ....  .......  .  .  ....  .  .  ....  .......
.     .        .     .           .  .                    .  .     .  .        .     .     .     .  .           .  .     .
.......  .......  .  ....  ....  .  .......  ..........  .......  ..........  .......  .  .  ....  .  .......  .......  .
.        .     .  .        .  .  .                    .  .     .  .           .        .     .  .     .                 .
.  .  ....  .  ....  ....  .  .......  .......  ..........  .  .  ....  ....  .......  ....  .  ....  .  .  .......  ....
.  .  .  .  .  .        .  .     .     .  .  .     .  .  .  .     .     .              .  .        .  .  .        .  .  .
.  .  .  .  ....  ..........  .  .......  .  .......  .  .  ....  .............  .  ....  .  ....  .  ..........  ....  .
.  .        .              .  .                 .     .     .  .  .        .     .        .  .           .              .
....  ..........  .............  .  ....  .......  .  .......  ....  .......  ....  .  .  .......  ....  ..........  ....
.        .           .           .     .        .  .  .     .           .     .     .  .  .        .        .  .     .  .
....  .  .  .......  .......  .......  ..........  .  ....  .  .............  ................  .............  .  ....  .
.     .  .  .     .     .        .        .     .  .  .              .  .  .                 .  .        .     .  .     .
.  .  .  .  .  .  .  .............  .  ....  ....  ....  ....  ....  .  .  .  .  ....  ..........  ..........  .  ....  .
.  .  .  .  .  .     .           .  .  .        .     .  .     .              .  .     .     .  .        .        .     .
....  .  .  .......  .  .  .  .  .  .  .......  .  .  ....  .  ....  ....  .  ..........  .  .  .  .  ..........  ....  .
.     .           .  .  .  .  .     .           .  .  .     .  .     .  .  .  .     .     .        .     .              .
....  .  ..........  .......  ....  .  .............  .  .  ....  ....  .  .  ....  .  .......  ..........  .  ..........
.     .  .                    .     .              .     .  .  .  .  .     .  .           .  .     .        .           .
..........  ....  .  ....  ....  .......  ................  .  ....  ....  ....  .  .......  .............  ..........  .
.     .     .     .     .     .  .     .     .        .  .        .     .  .  .  .  .  .        .              .        .
....  .............  .  .......  .  .......  ....  ....  .......  .  .......  .  ....  ....  .......  ....  ..........  .
.     .     .     .  .  .  .     .        .     .     .     .  .        .  .                 .           .        .  .  .
.  ....  .  .  ....  ....  .  .......  .......  ....  ....  .  .......  .  ....  .  ....  .......  .  ..........  .  .  .
.        .           .           .        .        .  .  .     .        .        .  .        .     .  .  .     .  .     .
.  .......  .  .  ....  .......  ....  ....  ....  .  .  .  ..........  .......  ..........  ..........  ....  .......  .
.     .     .  .     .     .           .  .  .        .              .     .     .  .        .     .           .  .  .  .
.  .  ....  .  ....  .  ....  ..........  ....  .  ....  ..........  .  .  .  .  .  .  ..........  .......  ....  .  .  .
.  .  .  .  .  .  .  .     .     .           .  .  .     .     .     .  .     .     .  .  .  .        .        .        .
.......  .  ....  .  .............  .  ..........  .  .......  ....  .......  ....  .  .  .  ....  .  ....  ....  .......
.              .     .     .        .        .     .     .  .                 .     .     .  .  .  .        .        .  .
.  .......  .  .......  .  ..........  .......  .......  .  .  ...................  .......  .  .......  ....  .......  .
.  .     .  .     .     .  .  .     .     .        .     .  .  .  .     .           .  .              .           .     .
....  ....  .......  .......  .  ....  .  .  ....  .  .  .  .  .  .  .  .  .  .  .  .  .......  ....  .  .......  .  ....
.        .  .     .                 .  .  .     .  .  .  .     .  .  .  .  .  .  .           .     .     .  .     .     .
.......  .  .  ....  ...................  .......  .......  .  .  .  .......  .  .............  .......  .  .  ....  ....
.  .  .  .        .  .  .                 .  .  .           .     .  .     .  .  .     .              .     .           .
.  .  .  ..........  .  .  .  ....  .  ....  .  .  .  ....  .......  ....  .  .......  .  .......  .......  .......  ....
.        .        .        .     .  .        .  .  .  .  .        .  .           .     .  .     .        .     .        .
....  .  .......  .......  .......  .......  .  ....  .  ....  ....  ................  .  ....  .  ....  ....  .......  .
.     .  .        .  .        .  .  .  .  .  .              .        .        .        .  .     .  .        .  .        .
.  ....  .  .......  ....  .  .  ....  .  .  ....  ......................  ....  ....  .  ....  ....  .......  .......  .
.  .  .              .     .        .        .        .  .           .        .  .     .        .     .              .  .
....  .  ....  .............  .  ...................  .  .  ....  .  ....  ....  ....  ....  .  .  .  .  ....  .  ....  .
.  .        .           .  .  .  .           .  .  .           .  .  .        .  .     .     .  .  .  .  .     .  .     .
.  .......  .............  .  .  .  ....  .  .  .  ....  ....  .............  .  ....  .  ..........  .  ................
.        .  .  .           .  .  .  .     .  .  .           .     .  .  .        .     .     .        .  .        .     .
.  ....  .  .  .  ..........  ....  ....  ....  ....  ....  .......  .  .  .  ....  .  .......  .......  .  .  .......  .
.     .  .           .                 .        .     .              .  .  .  .     .     .     .     .     .        .  .
.  .  ....  .......  .......  .  .  .  .......  .  .  .......  .......  .  .............  .  ....  ....  .  .  .  .  .  .
.  .     .     .              .  .  .  .           .  .     .                 .  .  .     .        .     .  .  .  .  .  .
.  .  .............  .............  ....  ....  ....  .  .......  ....  .......  .  .......  ......................  .  .
.  .     .  .     .  .  .        .     .  .     .  .        .  .  .  .                    .           .  .  .  .        .
.  .......  ....  ....  .  ....  .  ..........  .  .......  .  ....  ....  ....  ....  .  .  .  ....  .  .  .  .  .......
.     .     .  .     .        .        .     .  .     .           .  .  .  .  .  .  .  .  .  .     .        .  .     .  .
....  ....  .  .  ....  ....  .  .  .  .  ....  .  ....  ....  ....  .  .  .  .  .  .  .  ....  ....  .......  ....  .  .
.              .     .     .  .  .  .  .  .  .  .           .     .  .  .     .  .     .  .  .     .        .     .     .
.  .  .  ....  ....  .......  ....  ....  .  .  ....  .  .......  .  .  .  .  ....  ....  .  ..........  .  .  ..........
.  .  .  .        .           .     .     .     .     .     .  .        .  .  .        .     .  .        .              .
....  ....  ....  .  .  .  ....  ....  ....  ....  .  .  ....  .  .  ....  .  .  .  ....  ....  .  ..........  .......  .
.     .        .     .  .     .     .           .  .  .  .        .     .  .  .  .  .        .           .        .    X.
.........................................................................................................................