.............................................................
.         .     .     .     .  .              .             .
.......  .  .  ....  .  ....  .......  .......  .......  ....
.           .                 .              .        .  .  .
....  ....  .......  .  ....  .  .  .  .  .  ....  .......  .
.     .        .  .  .  .     .  .  .  .  .  .  .           .
....  ..........  ....  ..........  .......  .  ....  .......
.              .        .  .     .  .           .  .  .     .
..........  .  .  .......  .  .......  .  .......  .  .  .  .
.        .  .  .                 .  .  .                 .  .
.  ....  .  .......  .  ..........  ....  .  .  ....  .......
.     .  .  .        .  .     .  .     .  .  .     .  .     .
.  .  .  .  .......  .  .  ....  .  .......  .  ....  ....  .
.  .  .   X .        .     .  .  .        .  .     .     .  .
.  ..........  ....  .  ....  .  ....  .............  .  .  .
.        .  .  .  .  .     .  .     .           .     .     .
.......  .  .  .  .......  .  ....  .  .  .......  ....  ....
.           .     .  .        .        .     .     .        .
.  ....  .......  .  .  .  .......  ..........  ..........  .
.     .  .           .  .                             .     .
.............................................................