...............................
.           .  .           .  .
.  ....  .  .  .  .......  .  .
.  .     .        .           .
.  .......  .......  .  .......
.     .        .     .        .
....  .............  .  ....  .
.  .  .              .  .  .  .
.  .............  .......  ....
.        .     .        .  .  .
.......  ....  .......  .  .  .
.  .     .  .        .  .     .
.  ....  .  .  .  ....  .  ....
.  .  .     .  .     .        .
.  .  ....  .  .  ....  ....  .
.  .  .  .     .           .  .
.  .  .  .  .  ....  .  .  .  .
.        .  .     .  .  .  .  .
....  .  .  ....  .......  ....
.     .     .           .    X.
...............................