.....................................
.  .  .        .        .           .
.  .  .  .......  .......  ..........
.  .     .                    .  .  .
.  ....  ....  ................  .  .
.  .  .     .              .  .     .
.  .  .  ....  .  .......  .  ....  .
.              .     .              .
.  .  .......  .  .  .  .......  ....
.  .     .  .  .  .  .     .        .
.  .......  .  .......  .......  ....
.  .     .     .      x .  .     .  .
.  .  .  .......  .  .  .  .  ....  .
.     .        .  .  .  .           .
..........  .......  ....  .  .......
.  .  .  .  .     .     .  .     .  .
.  .  .  .  ....  ....  .  ....  .  .
.  .  .           .     .  .  .  .  .
.  .  .  ....  ....  ....  .  .  .  .
.           .     .     .  .        .
.  ..........  ....  ..........  ....
.  .           .        .        .  .
..........  ..........  ....  .  .  .
.              .        .  .  .     .
.  .  .  ..........  ....  ....  ....
.  .  .        .  .  .  .        .  .
.......  ....  .  ....  .  .  .  .  .
.  .     .     .     .     .  .  .  .
.  .  ....  .......  .  .  .......  .
.  .     .     .        .           .
.  .  ....  .......  ....  .  .  ....
.     .     .        .  .  .  .     .
.  .............  ....  .  ....  .  .
.     .        .  .     .  .  .  .  .
.  ....  ....  .  .  ....  .  .  ....
.  .  .  .     .  .     .  .        .
.  .  .......  ....  ..........  ....
.     .           .     .        .  .
.......  .  .  ....  .  .......  .  .
.        .  .        .              .
.....................................

