.......................................................................................................
.     .        .  .           .           .     .     .  .     .        .  .  .                       .
.  .  ....  ....  .......  .  ....  .......  .......  .  .  ....  .......  .  .  .......  .............
.  .                             .        .  .        .     .     .  .  .           .  .  .     .     .
.  .  .  ....  ....  .  .  ....  .  ....  .  .  .  ....  ....  ....  .  ....  .......  .  .  .......  .
.     .  .     .     .  .  .  .        .     .  .     .     .     .     .           .     .     .     .
....  .  .  ....  ....  ....  .  .............  ..........  ....  .  .  ....  .  .......  .  ....  .  .
.        .  .     .     .     .           .     .     .  .           .        .  .  .  .           .  .
.  ................  ....  .......  ..........  .  ....  .  ......................  .  .  .  ..........
.  .  .           .  .  .     .  .  .  .           .        .           .        .     .  .     .     .
.  .  ....  .......  .  .  .  .  .  .  .......  ....  .......  .  .  ....  .  ....  ....  .  .......  .
.  .              .  .     .              .  .        .  .  .  .  .        .        .  .  .  .        .
.  .  .............  .......  .......  .  .  ..........  .  .......  ....  .  .  .  .  ....  .  .......
.  .     .                 .  .     .  .           .     .  .  .     .  .  .  .  .  .  .              .
.  .  ....  .......  ....  .......  .  ....  .  ....  .  .  .  ....  .  ....  ....  .  ....  .......  .
.  .        .        .           .  .  .     .  .     .        .     .  .     .  .  .     .  .     .  .
.  .  .  .  .  ....  .  ..........  .......  .......  ................  .  ....  .......  .  ....  ....
.  .  .  .  .     .  .  .     .     .  .  .     .           .  .     .  .           .     .           .
.  .  ....  .......  ....  .  ....  .  .  .  .  ....  .......  .  ....  .  .......  .  ....  .  ....  .
.  .  .  .     .  .  .     .                 .                 .  .              .  .     .  .     .  .
.......  .......  ....  ...................  ................  .  .......  .......  .  .  ..........  .
.     .     .  .     .     .  .        .        .  .  .  .     .  .  .        .  .     .              .
.  .  ....  .  .  ....  ....  .......  ....  ....  .  .  ....  .  .  .  .......  ....  .......  .......
.  .     .           .  .        .     .              .  .           .     .     .     .     .        .
.  .  .......  .  .............  ....  .......  .  .  .  .......  .......  .  ....  ....  ....  .  .  .
.  .  .  .     .        .           .  .  .  .  .  .        .  .  .  .  .     .  .  .     .  .  .  .  .
.  .  .  .  ....  ....  ..........  .  .  .  ....  .  .......  .  .  .  .  ....  ....  ....  ....  .  .
.  .           .     .     .  .  .     .     .  .  .     .              .     .     .     .        .  .
.  .  ..........  ....  .  .  .  .  ....  ....  .  .......  .  .  ....  ....  .  ....  .......  ....  .
.  .           .  .     .                       .     .     .  .  .  .                       .  .  .  .
.......  .  .  ....  ....  .......  .......  ................  ....  .......  .  ....  .  .......  .  .
.  .  .  .  .  .     .  .        .  .  .     .        .     .     .        .  .  .     .           .  .
.  .  ................  .  ..........  ....  ....  ....  ....  .  ....  .  .......  .  .  .............
.        .     .           .                 .     .     .     .  .     .  .        .  .              .
....  ....  .  ....  .  ..........  .  ..........  .  ....  ....  .......  .......  ....  .  .......  .
.           .  .  .  .  .  .  .  .  .  .              .        .  .  .     .  .  .  .     .     .     .
.......  ....  .  ....  .  .  .  .......  ....  .  .  ....  .  .  .  ....  .  .  .  ..........  ....  .
.     .     .     .                 .     .     .  .     .  .  .  .           .              .  .     .
.  .  .  ....  .  .  .........................  ..........  .  .......  .  .......  .  .  ..........  .
.  .  .     .  .        .  .                       .  .     .  .     .  .        .  .  .  .           .
.  .  .  .  .  .......  .  .......  .  .......  .  .  .......  .  ....  .  .  ................  ....  .
.  .  .  .  .  .        .     .  .  .  .     .  .     .  .              .  .  .              .  .     .
.  .......  .  ..........  ....  ....  .  .  .  .  ....  .  .  .......  .............  .  .............
.           .     .  .           .        .  .  .        .  .  .     .     .  .  .  .  .           .  .
....  .............  .......  .  ....  ..........  .  .  .  .  ....  .  ....  .  .  ....  .......  .  .
.  .  .  .  .        .     .  .  .  .     .        .  .  .  .  .  .        .     .  .     .     .     .
.  .  .  .  ....  .  ....  ....  .  .......  .......  .......  .  .......  ....  .  .......  .  ....  .
.  .           .  .  .        .     .        .  .  .  .              .  .     .     .     .  .        .
.  ..........  ....  ....  .......  .  .......  .  .  .  .  .  .......  .  .  .  ....  .  ....  ....  .
.  .     .                    .              .        .  .  .        .     .  .  .  .  .  .  .     .  .
.  .  .......  .  .......  .  ....  .  ....  ....  ...................  .  ....  .  .  .  .  .  ....  .
.     .        .     .  .  .        .     .  .  .        .     .        .           .  .        .     .
....  .  .  .  ....  .  .  .......  .  .......  .  .  .......  .  ....  .  ....  .  .  ....  .......  .
.        .  .  .     .        .  .  .     .  .     .     .           .  .  .  .  .  .     .  .  .     .
.........................  .  .  ....  ....  .  ...................  .  ....  ..........  ....  .  ....
.        .     .     .     .     .           .  .     .  .        .  .           .        .     .  .  .
.......  .  .  .  .  .......  ....  ....  .......  ....  .......  ....  ....  ..........  .  .  ....  .
.           .     .           .     .     .     .        .        .  .  .  .              .  .     .  .
.  ....  .......  .......  .  ....  .  .......  ....  .......  .  .  .  .  .......  .  ....  .  .  .  .
.  .        .  .        .  .  .  .  .  .        .     .        .  .  .        .     .     .  .  .     .
.  ..........  .  ....  ....  .  .............  .  .  .  ....  .  .  ...................  .  ..........
.     .     .        .  .     .  .           .     .        .  .        .  .  .     .        .     .  .
....  .  .  .  .  ..........  .  .  ..........  ....  .......  ..........  .  .  .  .  .  ....  ....  .
.     .  .  .  .     .     .     .              .           .     .  .     .     .     .  .           .
....  .  .............  .  .  .......  .  .......  .  .............  .  .......  .  ....  ....  ....  .
.     .     .  .     .  .        .     .  .        .        .     .        .     .     .        .     .
.  ....  .  .  .  ..........  .  ....  .............  ....  ....  .  .  ....  ...................  ....
.        .           .  .  .  .        .     .        .  .           .  .        .  .  .              .
.  ....  .......  ....  .  .......  .  ....  ....  ....  .............  .  .  ....  .  .  .......  ....
.     .     .  .     .        .  .  .        .     .  .        .           .  .        .  .  .  .  .  .
.  .  .......  .  .  ....  ....  .  ....  .......  .  .  .  .  ....  .......  ....  .  .  .  .  ....  .
.  .     .     .  .  .        .        .  .     .     .  .  .     .  .        .     .  .     .        .
.  ..........  .  ....  .  ....  .  .  .  .  ....  ....  ....  .............  .  .  .  ....  .  .  ....
.        .        .     .  .     .  .  .  .  .  .  .  .  .  .     .  .        .  .  .  .        .  .  .
.......  .......  .  ....  .............  .  .  ....  ....  .  .  .  .......  ....  .......  .  ....  .
.        .           .     .           .  .  .     .           .     .     .        .        .        .
....  ....  ....  ................  .  ....  .  .  .  ....  ....  ....  .......  .  ....  ....  .......
.     .  .  .        .           .  .           .     .        .     .           .  .     .           .
.......  .  ....  .......  .......  .  .  .  .............  .......  .  .............  ..........  ....
.     .  .  .                    .  .  .  .     .     .        .           .  .           .  .        .
.  .  .  ....  .  .  ....  .............  .......  .  .  .  .  ..........  .  ..........  .  ....  ....
.  .     .     .  .     .     .        .  .     .  .     .  .           .     .              .        .
.  ....  ...................  ....  .  .......  ..........  .......  ....  ....  ................  ....
.     .  .              .           .                 .     .     .  .        .  .     .     .        .
.  ....  .............  .  ....  .......  ....  ..........  .  .  ....  .......  .  .  .  .  .  .  .  .
.     .                       .  .        .        .           .  .           .  .  .     .     . X.  .
.......................................................................................................