............................
.           .  .           .
.  .  ....  .  .  .......  .
.  .  .        .        .  .
.......  ....  ..........  .
.        .                 .
..........  .  .......  .  .
.     .     .  .     .  .  .
....  .  ....  .  .  .......
.     .     .     .  .  .  .
.  .  .......  ....  .  .  .
.  .        .  .           .
.  .......  ....  ....  ....
.  .     .  .     .  .  .  .
.  .  ....  .......  .  .  .
.  .           .  .  .  .  .
..........  ....  .  .  .  .
.                         X.
............................