.................................
.                               .
. . . . . . . . . . . . . . . . .
.                               .
. . . . . . . . . . . . . . . . .
.                               .
. . . . . . . . X . . . . . . . .
.                               .
. . . . . . . . . . . . . . . . .
.                               .
. . . . . . . . . . . . . . . . .
.................................