.............................................................
.  .  .     .              .              .              .  .
.  .  ....  .  .  ..........  .......  ....  ..........  .  .
.        .  .  .  .  .  .  .        .              .  .     .
....  ....  .  ....  .  .  .  .  ....  .  ..........  .  ....
.     .           .  .     .  .  .     .        .           .
.  ..........  ....  .  .......  .......  ....  ....  .  ....
.     .                          .           .     .  .     .
.  .......  .  .............  ....  ................  .  .  .
.     .     .     .     .  .     .        .           .  .  .
.  .  ....  ....X ....  .  ..........  .  .............  ....
.  .     .     .        .        .     .  .  .  .           .
.  .  ....  .  ..........  ....  .  .  ....  .  ....  .......
.  .        .  .     .        .     .  .     .     .  .     .
.  .  .  ....  .  .............  .......  .  ....  .  .  .  .
.  .  .  .  .     .     .        .        .     .        .  .
.  .  .  .  ....  .  .  .......  .  ....  .......  ....  ....
.  .  .     .  .  .  .              .        .     .     .  .
.  ....  ....  ................  .......  .  .  ..........  .
.  .     .     .     .  .              .  .  .     .        .
.  ....  ....  .  ....  .............  ................  .  .
.  .     .              .  .           .     .     .  .  .  .
.  .......  ....  .  ....  ..........  .  .  .  .  .  .  .  .
.  .  .  .     .  .                       .     .  .     .  .
....  .  .  .......  .  .............  ....  ....  ....  ....
.  .              .  .     .     .     .  .     .           .
.  .  .............  .  .  .  .......  .  ....  .............
.     .        .  .  .  .        .  .  .     .     .  .     .
.  .  .  .......  .  ..........  .  .......  .  ....  .  ....
.  .  .     .  .        .                 .     .  .  .     .
....  ....  .  .  ................  ..........  .  .  .  .  .
.     .  .  .  .  .     .  .  .              .     .     .  .
....  .  .  .  .  .  ....  .  .  .......  .......  .  .......
.     .        .  .  .        .  .  .     .     .        .  .
.  .  ....  .......  ....  .  .  .  ....  .  .......  .  .  .
.  .     .  .              .        .     .           .     .
.  .  ....  ....  ....  .  ..........  .............  ....  .
.  .  .           .     .  .        .  .  .  .     .  .     .
.......  .  ....  ................  ....  .  .  ..........  .
.        .  .                       .                       .
.............................................................