..........
.        .
........ .
.  .     .
.  .  ....
. X      .
..........