.............................................................
.   .           .              .  .  .  .  .  .  .  .       .
.   .  ....  ....  .......  ....  .  .  .  .  .  .  ...  ....
.        .     .  .  .                 .        .           .
.  ....  .......  .  .  .............  .  ................  .
.     .  .  .        .  .  .     .              .     .     .
....  .  .  .  .  ....  .  ....  .  ....  .......  .  ....  .
.     .     .  .  .     .     .     .  .  .     .  .        .
.  .......  ..........  .  .......  .  .  .  .  ....  .  .  .
.     .  .  .  .     .  .  .        .  .  .  .     .  .  .  .
.  ....  .  .  .  ....  .  ....  .  .  .  .  ..........  .  .
.        .              .     .  .     .        .     .  .  .
.  .......  .  .  .  .  .  .............  ....  ....  ....  .
.     .     .  .  .  .     .  .        .  .     .  .        .
....  .  .  ................  .  ....  .......  .  .  ....  .
.  .     .        .  .        .  .  .  .                 .  .
.  ................  .  .......  .  ..........  .......  ....
.        .  .     .        .     .        .     .  .        .
.  .......  .  .  .......  .  ..........  .......  ....  ....
.     .        .     .  .        .  .        .  .     .     .
.  .............  ....  ....  ....  .  ....  .  ....  ....  .
.        .                       .        .  .           .  .
.  .......  .......  ..........  ....  .......  ....  .  .  .
.     .  .     .              .  .                 .  .     .
.  ....  .  ....  ....  .  .......  ....  ....  ....  ....  .
.              .     .  .     .  .     .  .     .  .  .     .
..........  .  .............  .  ....  ....  ....  .......  .
.  .  .  .  .        .                 .  .     .  .        .
.  .  .  .  .......  .  ....  ....  .  .  ....  .  ....  .  .
.        .  .        .  .        .  .        .  .     .  .  .
.  ....  .......  .......  .  ..........  .  .......  .  ....
.     .  .        .        .     .  .  .  .     .  .        .
....  .......  ....  ..........  .  .  ..........  .......  .
.     .  .     .  .     .  .        .        .  .  .  .     .
....  .  .......  .  ....  ................  .  .  .  .  .  .
.                    .  .        .        .        .     .  .
.  ................  .  .  .  .......  .......  .......  .  .
.  .     .     .           .  .  .                       .  .
.  ....  .  .  .  .......  .  .  .  .  .  .......  ....  ....
.  .  .  .  .     .  .     .  .     .  .        .     .     .
....  .  .  .......  ................  ....  .  ....  .  .  .
.     .  .           .     .     .  .     .  .  .     .  .  .
.  ....  .......  ....  .  ....  .  .  .......  .  .......  .
.           .           .  .        .  .        .        .  .
....  .  ..........  .......  .......  .  .  .  .......  .  .
.     .           .     .     .  .  .  .  .  .     .  .  .  .
.  ....  .  ..........  ....  .  .  .  ....  .  ....  ....  .
.     .  .                 .           .     .     .       X.
.............................................................